S..#######
##.......#
#####.####
#####.####
.#........
#####.####
#####.....
.#....####
###.#.....
#########G